MAP
s grass
0  0 1 2 3 4 5 6 7 8 9 10 11 12 13 14    
1  0   2 3 4 5 6 7 8 9 10 11 12 13 14    
2  0 1 2 3 4 5 6 7 8 9 10 11 12 13 14    
3  0 1 2 3 4 5 6 7 8 9 10 11 12 13 14    
4  0 1 2 3 4 5 6 7 8 9 10 11 12 13 14    
5  0 1 2 3 4 5 6 7 8 9 10 11 12 13 14    
6  0 1 2 3 4 5 6 7 8 9 10 11 12 13 14    
7  0 1 2 3 4 5 6 7 8 9 10 11 12 13 14
8  0 1 2 3 4 5 6 7 8 9 10 11 12 13 14    
9  0 1 2 3 4 5 6 7 8 9 10 11 12 13 14       17 
10 0 1 2 3 4 5 6 7 8 9 10 11 12 13 14 15 16 17 18 19 
11 0 1 2 3 4 5 6 7 8 9 10 11 12 13 14       17 18 
12 0 1 2 3 4 5 6 7 8 9 10 11 12 13 14    
13 0 1 2 3 4 5 6 7 8 9 10 11 12 13 14    
14 0 1 2 3 4 5 6 7 8 9 10 11 12 13 14    
15 0 1 2 3 4 5 6 7 8 9 10 11 12 13 14    
16 0 1 2 3 4 5 6 7 8 9 10 11 12 13 14    
17 0 1 2 3 4 5 6 7 8 9 10 11 12 13 14    
18 0 1 2 3 4 5 6 7 8 9 10 11 12 13 14    
19 0 1 2 3 4 5 6 7 8 9 10 11 12 13 14    
20 0 1 2 3 4 5 6 7 8 9 10 11 12 13 14    
21 0 1 2 3 4 5 6 7 8 9 10 11 12 13 14      
s cave
0                                      16 17 18 19 20 21 22 23 24 25 26 27 28 29
1                                      16 17 18 19 20 21 22 23 24 25 26 27 28 29
2                                      16 17 18 19 20 21 22 23 24 25 26 27 28 29
3                                      16 17 18 19 20 21 22 23 24 25 26 27 28 29
4                                      16 17 18 19 20 21 22 23 24 25 26 27 28 29
5                                      16 17 18 19 20 21 22 23 24 25 26 27 28 29
6                                      16 17 18 19 20 21 22 23 24 25 26 27 28 29
7                                      16 17 18 19 20 21 22 23 24 25 26 27 28 29
8                                      16 17 18 19 20 21 22 23 24 25 26 27 28 29
9                                      16    18 19 20 21 22 23 24 25 26 27 28 29
10                                              19 20 21 22 23 24 25 26 27 28 29
11                                     16       19 20 21 22 23 24 25 26 27 28 29
12                                     16 17 18 19 20 21 22 23 24 25 26 27 28 29
13                                     16 17 18 19 20 21 22 23 24 25 26 27 28 29
14                                     16 17 18 19 20 21 22 23 24 25 26 27 28 29
15                                     16 17 18 19 20 21 22 23 24 25 26 27 28 29
16                                     16 17 18 19 20 21 22 23 24 25 26 27 28 29
17                                     16 17 18 19 20 21 22 23 24 25 26 27 28 29
18                                     16 17 18 19 20 21 22 23 24 25 26 27 28 29
19                                     16 17 18 19 20 21 22 23 24 25 26 27 28 29
20                                     16 17 18 19 20 21 22 23 24 25 26 27 28 29
21                                     16 17 18 19 20 21 22 23 24 25 26 27 28 29
22                                     16 17 18 19 20 21 22 23 24 25 26 27 28 29
23 0 1 2 3 4 5 6 7 8 9 10 11 12 13 14 15 16 17 18 19 20 21 22 23 24 25 26 27 28 29
24 0 1 2 3 4 5 6 7 8 9 10 11 12 13 14 15 16 17 18 19 20 21 22 23 24 25 26 27 28 29
25 0 1 2 3 4 5 6 7 8 9 10 11 12 13 14 15 16 17 18 19 20 21 22 23 24 25 26 27 28 29
26 0 1 2 3 4 5 6 7 8 9 10 11 12 13 14 15 16 17 18 19 20 21 22 23 24 25 26 27 28 29
27 0 1 2 3 4 5 6 7 8 9 10 11 12 13 14 15 16 17 18 19 20 21 22 23 24 25 26 27 28 29
28 0 1 2 3 4 5 6 7 8 9 10 11 12 13 14 15 16 17 18 19 20 21 22 23 24 25 26 27 28 29
29 0 1 2 3 4 5 6 7 8 9 10 11 12 13 14 15 16 17 18 19 20 21 22 23 24 25 26 27 28 29

s tree
0            5   7                    15
1                7                    15
2  5               8                  15
3  0 1 2 3 4 5       9                15
4                  8      11 12 13 14 15
5                    9    11          15
6                                     15
7                      10 11          15
8                    9                15
9                    9                15
10           5 6 7 8                    
11     2 3 4                          15
12 0 1 2                              15
13                                    15
14                                    15
15                                    15
16                                    15
17                                    15
18                                    15
19                                    15
20                                    15
21                                    15
22 0 1 2 3 4 5 6 7 8 9 10 11 12 13 14 15
23 
24
25 
26 
27 
28 
29 

s man3
1 1

s wep1
4 2

s blob
1 13
0 12
5 2
7 6
9 5

s bug2
1 12
2 9
3 11
4 3
8 1

s fountain
2 4

s fighter
10 16

s man1
6 11

s bug1
16 8
13 13
20 2 7 12
17 13 3

s bug3
12 11
16 10 14
20 2
