MAP
s grass
0  1 2 3 4 5 6 7 8 9 10 11 12 13 14    
1  1 2 3 4 5 6 7 8 9 10 11 12 13 14    
2  1 2 3 4 5 6 7 8 9 10 11 12 13 14    
3  1 2 3 4 5 6 7 8 9 10 11 12 13 14    
4  1 2 3 4 5 6 7 8 9 10 11 12 13 14    
5  1 2 3 4 5 6 7 8 9 10 11 12 13 14    
6  1 2 3 4 5 6 7 8 9 10 11 12 13 14    
7  1 2 3 4 5 6 7 8 9 10 11 12 13 14
8  1 2 3 4 5 6 7 8 9 10 11 12 13 14    
9  1 2 3 4 5 6 7 8 9 10 11 12 13 14       17 
10 1 2 3 4 5 6 7 8 9 10 11 12 13 14 15 16 17 18 19 
11 1 2 3 4 5 6 7 8 9 10 11 12 13 14       17 18 
12 1 2 3 4 5 6 7 8 9 10 11 12 13 14    
13 1 2 3 4 5 6 7 8 9 10 11 12 13 14    
14 1 2 3 4 5 6 7 8 9 10 11 12 13 14    
15 1 2 3 4 5 6 7 8 9 10 11 12 13 14    
16 1 2 3 4 5 6 7 8 9 10 11 12 13 14    
17 1 2 3 4 5 6 7 8 9 10 11 12 13 14    
18 1 2 3 4 5 6 7 8 9 10 11 12 13 14    
19 1 2 3 4 5 6 7 8 9 10 11 12 13 14    
20 1 2 3 4 5 6 7 8 9 10 11 12 13 14    
21 1 2 3 4 5 6 7 8 9 10 11 12 13 14      
s cave
0                                      16 17 18 19 20 21 22 23 24 25 26 27 28 29
1                                      16 17 18 19 20 21 22 23 24 25 26 27 28 29
2                                      16 17 18 19 20 21 22 23 24 25 26 27 28 29
3                                      16 17 18 19 20 21 22 23 24 25 26 27 28 29
4                                      16 17 18 19 20 21 22 23 24 25 26 27 28 29
5                                      16 17 18 19 20 21 22 23 24 25 26 27 28 29
6                                      16 17 18 19 20 21 22 23 24 25 26 27 28 29
7                                      16 17 18 19 20 21 22 23 24 25 26 27 28 29
8                                      16 17 18 19 20 21 22 23 24 25 26 27 28 29
9                                      16    18 19 20 21 22 23 24 25 26 27 28 29
10                                              19 20 21 22 23 24 25 26 27 28 29
11                                     16       19 20 21 22 23 24 25 26 27 28 29
12                                     16 17 18 19 20 21 22 23 24 25 26 27 28 29
13                                     16 17 18 19 20 21 22 23 24 25 26 27 28 29
14                                     16 17 18 19 20 21 22 23 24 25 26 27 28 29
15                                     16 17 18 19 20 21 22 23 24 25 26 27 28 29
16                                     16 17 18 19 20 21 22 23 24 25 26 27 28 29
17                                     16 17 18 19 20 21 22 23 24 25 26 27 28 29
18                                     16 17 18 19 20 21 22 23 24 25 26 27 28 29
19                                     16 17 18 19 20 21 22 23 24 25 26 27 28 29
20                                     16 17 18 19 20 21 22 23 24 25 26 27 28 29
21                                     16 17 18 19 20 21 22 23 24 25 26 27 28 29
22                                     16 17 18 19 20 21 22 23 24 25 26 27 28 29
23 1 2 3 4 5 6 7 8 9 10 11 12 13 14 15 16 17 18 19 20 21 22 23 24 25 26 27 28 29
24 1 2 3 4 5 6 7 8 9 10 11 12 13 14 15 16 17 18 19 20 21 22 23 24 25 26 27 28 29
25 1 2 3 4 5 6 7 8 9 10 11 12 13 14 15 16 17 18 19 20 21 22 23 24 25 26 27 28 29
26 1 2 3 4 5 6 7 8 9 10 11 12 13 14 15 16 17 18 19 20 21 22 23 24 25 26 27 28 29
27 1 2 3 4 5 6 7 8 9 10 11 12 13 14 15 16 17 18 19 20 21 22 23 24 25 26 27 28 29
28 1 2 3 4 5 6 7 8 9 10 11 12 13 14 15 16 17 18 19 20 21 22 23 24 25 26 27 28 29
29 1 2 3 4 5 6 7 8 9 10 11 12 13 14 15 16 17 18 19 20 21 22 23 24 25 26 27 28 29
s tree
0  15
1  15
2  15
3  15
4  15
5  15
6  15
7  15
8  15
9  15
10 
11 15
12 15
13 15
14 15
15 15
16 15
17 15
18 15
19 15
20 15
21 15
22 0 1 2 3 4 5 6 7 8 9 10 11 12 13 14 15
23 
24
25 
26 
27 
28 
29 
